about (adv)	/əˈbaʊt/	khoảng
along (adv)	/əˈlɑːŋ/	dọc theo
amount (n)	/əˈmaʊnt/	số lượng
angry (adj)	/ˈæŋ.ɡri/	giận dữ
another (adj)	/əˈnʌð.ɚ/	khác
anytime (adv)	/ˈen.i.taɪm/	bất kỳ lúc nào
appear (v)	/əˈpɪr/	xuất hiện
area (n)	/ˈer.i.ə/	khu vực, diện tích
autumn (n)	/ˈɑː.t̬əm/	mùa thu
away (adv)	/əˈweɪ/	ở xa
back (n)	/bæk/	lưng
base (n)	/beɪs/	đáy, nền tảng
basket (n)	/ˈbæs.kət/	cái giỏ
bath (n)	/bæθ/	bồn tắm
bean (n)	/biːn/	hạt đậu
bear (n, v)	/ber/	chịu đựng
bed (n)	/bed/	cái giường
beer (n)	/bɪr/	rượu bia
behave (v)	/bɪˈheɪv/	đối xử
belly button (n)	/ˈbel.i ˌbʌt̬.ən/	lỗ rốn
bowl (n)	/boʊl/	cái tô
breathe (v)	/briːð/	hít thở
bridge (n)	/brɪdʒ/	cây cầu
bright (adj)	/braɪt/	tươi sáng
bring (v)	/brɪŋ/	mang lại, mang đến
brother (n)	/ˈbrʌð.ɚ/	anh/em trai
brown (n)	/braʊn/	màu nâu
brush (n)	/brʌʃ/	bàn chải
build (v)	/bɪld/	xây dựng
burn (v)	/bɝːn/	đốt cháy
careless (adj)	/ˈker.ləs/	bất cẩn
carry (v)	/ˈker.i/	mang theo
case (n)	/keɪs/	tình huống
cat (n)	/kæt/	con mèo
catch (v)	/kætʃ/	bắt/nắm lấy
central (adj)	/ˈsen.trəl/	ở giữa, trung tâm
century (n)	/ˈsen.tʃər.i/	thế kỷ
certain (adj)	/ˈsɝː.tən/	chắc chắn
chair (n)	/tʃer/	cái ghế
chance (n)	/tʃæns/	cơ hội
change (n, v)	/tʃeɪndʒ/	sự thay đổi
chase (v)	/tʃeɪs/	theo đuổi
cheap (adj)	/tʃiːp/	rẻ
chest (n)	/tʃest/	ngực
clever (adj)	/ˈklev.ɚ/	thông minh, nhanh trí
copper (n)	/ˈkɑː.pɚ/	kim loại Đồng
corn (n)	/kɔːrn/	bắp
corner (n)	/ˈkɔːr.nɚ/	góc
decrease (v)	/ˈdiː.kriːs/	làm giảm đi
deep (adj)	/diːp/	sâu, sâu xa
deer (n)	/dɪr/	con hươu
depend (v)	/dɪˈpend/	phụ thuộc
desk (n)	/desk/	cái bàn
destroy (v)	/dɪˈstrɔɪ/	phá hủy
develop (v)	/dɪˈvel.əp/	phát triển
die (v)	/daɪ/	chết
direction (n)	/daɪˈrek.ʃən/	phương hướng
drink (n)	/drɪŋk/	thức uống
earth (n)	/ɝːθ/	trái Đất
east (n)	/iːst/	phía Đông
end (n)	/end/	giới hạn, sự kết thúc
enemy (n)	/ˈen.ə.mi/	kẻ địch
enjoy (v)	/ɪnˈdʒɔɪ/	tận hưởng
enough (adj)	/əˈnʌf/	đủ
enter (v)	/ˈen.t̬ɚ/	đi vào, tham gia
equal (adj)	/ˈiː.kwəl/	ngang bằng, bình đẳng
entrance (n)	/ˈen.trəns/	sự tiến vào
elbow (n)	/ˈel.boʊ/	cùi chỏ
escape (v)	/ɪˈskeɪp/	trốn thoát
even (adj)	/ˈiː.vən/	ngang bằng, bằng phẳng
except (prep)	/ɪkˈsept/	ngoại trừ
excited (adj)	/ɪkˈsaɪ.t̬ɪd/	phấn khích
exercise (v)	/ˈek.sɚ.saɪz/	tập thể dục
expect (v)	/ɪkˈspekt/	ngóng chờ, chờ đợi
expensive (adj)	/ɪkˈspen.sɪv/	đắt đỏ
explain (v)	/ɪkˈspleɪn/	giải thích
extremely (adv)	/ɪkˈstriːm.li/	vô cùng
eye (n)	/aɪ/	con mắt
face (n)	/feɪs/	gương mặt
fact (n)	/fækt/	sự thật
fail (v)	/feɪl/	thất bại, thi trượt
fingernail (n)	/ˈfɪŋ.ɡɚ.neɪl/	móng tay
float (v)	/floʊt/	trôi nổi
floor (n)	/flɔːr/	tầng (nhà)
flour (n)	/ˈflaʊ.ɚ/	bột
fold (v)	/foʊld/	gấp nếp
fool (adj)	/fuːl/	ngốc nghếch
foot (n)	/fʊt/	bàn chân
force (n)	/fɔːrs/	sức mạnh, lực lượng
forearm (n)	/ˈfɔːr.ɑːrm/	cẳng tay
further (adv)	/ˈfɝː.ðɚ/	xa hơn
hair (n)	/her/	tóc
hand (n)	/hænd/	bàn tay
half (n)	/hæf/	phân nửa, một nửa
hall (n)	/hɑːl/	đại sảnh
hat (n)	/hæt/	cái mũ
hold (v)	/hoʊld/	nắm, giữ
hole (n)	/hoʊl/	lỗ, ô trống
hungry (adj)	/ˈhʌŋ.ɡri/	đói
hour (n)	/aʊr/	giờ
hurry (v)	/ˈhɝː.i/	thúc giục
husband (n)	/ˈhʌz.bənd/	chồng
hurt (v)	/hɝːt/	làm bị thương
into (prep)	/ˈɪn.tuː/	vào trong
invent (v)	/ɪnˈvent/	phát minh, sáng tạo
iron (n)	/aɪrn/	Sắt
keep (v)	/kiːp/	lưu giữ, kẹp
kitchen (n)	/ˈkɪtʃ.ən/	căn bếp, phòng bếp
knee (n)	/niː/	đầu gối
knife (n)	/naɪf/	con dao
knock (v)	/nɑːk/	đập vào
know (v)	/noʊ/	biết
ladder (n)	/ˈlæd.ɚ/	cái thang
land (n)	/lænd/	đất liền
lock (n)	/lɑːk/	ổ khóa
lose (v)	/luːz/	đánh mất
mean (v)	/miːn/	nghĩa là, dự định
measure (v)	/ˈmeʒ.ɚ/	đo lường, đong đếm
meat (n)	/miːt/	thịt
medicine (n)	/ˈmed.ɪ.sən/	thuốc
method (n)	/ˈmeθ.əd/	phương thức, cách thức
middle (n)	/ˈmɪd.əl/	ở giữa
milk (n)	/mɪlk/	sữa
million (n)	/ˈmɪl.jən/	hàng triệu
mind (n)	/maɪnd/	tâm trí
minute (n)	/ˈmɪn.ɪt/	phút
miss (v)	/mɪs/	bỏ lỡ, nhỡ
mistake (n)	/mɪˈsteɪk/	sai sót, sai lầm
mouth (n)	/maʊθ/	cái miệng
move (v)	/muːv/	di chuyển
much (adj)	/mʌtʃ/	nhiều, lắm
museum (n)	/mjuːˈziː.əm/	bảo tàng
music (n)	/ˈmjuː.zɪk/	âm nhạc
noble (adj)	/ˈnoʊ.bəl/	quý tộc
noise (n)	/nɔɪz/	tiếng ồn
none (pron)	/nʌn/	không ai cả, không gì
nor (conj)	/nɔːr/	cũng không
north (n)	/nɔːrθ/	hướng Bắc
nose (n)	/noʊz/	cái mũi
not (adv)	/nɑːt/	không
nothing (n)	/ˈnʌθ.ɪŋ/	không có gì
notice (v)	/ˈnoʊ.t̬ɪs/	để ý, nhận ra
now (adv)	/naʊ/	bây giờ, hiện tại
number (n)	/ˈnʌm.bɚ/	số đếm
obey (v)	/oʊˈbeɪ/	tuân thủ
object (n)	/ˈɑːb.dʒɪkt/	đồ vật, vật thể, mục tiêu
ocean (n)	/ˈoʊ.ʃən/	đại dương
oil (n)	/ɔɪl/	dầu
old (adj)	/oʊld/	già, lớn tuổi
on (prep)	/ɑːn/	bên trên
one (n)	/wʌn/	số 1
period (n)	/ˈpɪr.i.əd/	thời kỳ, giai đoạn
petrol (n)	/ˈpet.rəl/	xăng dầu
pig (n)	/pɪɡ/	con heo
pin (n)	/pɪn/	đinh ghim
pink (n)	/pɪŋk/	màu hồng
place (n)	/pleɪs/	nơi, địa điểm
plane (n)	/pleɪn/	máy bay
plant (n)	/plænt/	thực vật, cây cối
plastic (n)	/ˈplæs.tɪk/	nhựa
plate (n)	/pleɪt/	đĩa thức ăn
prevent (v)	/prɪˈvent/	ngăn chặn, ngăn cản
prison (n)	/ˈprɪz.ən/	nhà tù, ngục tù
private (adj)	/ˈpraɪ.vət/	riêng tư, cá nhân
prize (n)	/praɪz/	giải thưởng
probably (adv)	/ˈprɑː.bə.bli/	có thể
problem (n)	/ˈprɑː.bləm/	vấn đề
produce (v)	/prəˈduːs/	sản xuất, tạo ra
quite (adv)	/kwaɪt/	tương đối, khá
radio (n)	/ˈreɪ.di.oʊ/	đài radio
rain (n)	/reɪn/	cơn mưa
rainy (adj)	/ˈreɪ.ni/	hay mưa
raise (v)	/reɪz/	tăng lên
rise (n)	/raɪz/	sự tăng lên
road (n)	/roʊd/	con đường
rob (v)	/rɑːb/	lấy trộm
rock (n)	/rɑːk/	đá
room (n)	/ruːm//rʊm/	buồng, phòng, chỗ
round (n)	/raʊnd/	vòng tròn
rubber (n)	/ˈrʌb.ɚ/	cao su
rude (adj)	/ruːd/	khiếm nhã
rush (n, v)	/rʌʃ/	sự vội vàng
sad (adj)	/sæd/	buồn bã
search (n)	/sɝːtʃ/	sự tìm kiếm
seat (n)	/siːt/	chỗ ngồi
sex (n)	/seks/	giới tính
shade (n)	/ʃeɪd/	bóng râm
shadow (n)	/ˈʃæd.oʊ/	bóng tối
shake (v)	/ʃeɪk/	rung, lắc
shape (n)	/ʃeɪp/	hình dáng
share (v)	/ʃer/	chia sẻ
sharp (adj)	/ʃɑːrp/	sắc bén, nhọn
shoot (n, v)	/ʃuːt/	cuộc săn bắn; bắn, săn
silly (adj)	/ˈsɪl.i/	ngờ nghệch, ngốc nghếch
silver (n, adj)	/ˈsɪl.vɚ/	kim loại Bạc
similar (adj)	/ˈsɪm.ə.lɚ/	giống nhau, tương tự
sink (n, v)	/sɪŋk/	bồn rửa, chậu rửa; chìm
slip (n, v)	/slɪp/	sự trượt chân; trượt, tuột
slow (adj)	/sloʊ/	chậm chạp, lâu
small (adj)	/smɑːl/	nhỏ bé
so (adv)	/soʊ/	như thế, cũng vậy
soap (v)	/soʊp/	xà phòng
sock (n)	/sɑːk/	vớ
stop (n, v)	/stɑːp/	điểm dừng, dừng lại
storm (n, v)	/stɔːrm/	cơn bão; lao vào, xông vào
story (n)	/ˈstɔːr.i/	câu chuyện
strange (adj)	/streɪndʒ/	kỳ lạ
street (n)	/striːt/	đường phố
strawberry (n)	/ˈstrɑːˌber.i/	quả dâu tây
strong (adj)	/strɑːŋ/	mạnh mẽ
structure (n)	/ˈstrʌk.tʃɚ/	cấu trúc
student (n)	/ˈstuː.dənt/	học sinh, sinh viên
sweet (n)	/swiːt/	sự ngọt ngào
swim (v)	/swɪm/	bơi
sword (n)	/sɔːrd/	gươm, kiếm, đao
table (n)	/ˈteɪ.bəl/	cái bàn
take (n, v)	/teɪk/	sự cầm, nắm; cầm, nắm, lấy
thin (adj)	/θɪn/	mỏng manh
thing (n)	/θɪŋ/	cái, đồ, vật, thứ
think (v)	/θɪŋk/	suy nghĩ
though (conj)	/ðoʊ/	mặc dù, tuy vậy, tuy nhiên
threat (n)	/θret/	sự đe dọa
three (n)	/θriː/	số 3
tidy (adj, v)	/ˈtaɪ.di/	sạch sẽ, ngăn nắp; dọn dẹp
tie (n)	/taɪ/	cà vạt
title (n)	/ˈtaɪ.t̬əl/	danh hiệu
to (prep)	/tuː/	theo, tới, để
today (n)	/təˈdeɪ/	hôm nay
toe (n)	/toʊ/	ngón chân
together (adv)	/təˈɡeð.ɚ/	cùng nhau
tomorrow (n, adv)	/təˈmɔːr.oʊ/	ngày mai
town (n)	/taʊn/	thị trấn
train (n)	/treɪn/	xe lửa
tram (n)	/træm/	xe điện
travel (n, v)	/ˈtræv.əl/	chuyến đi; đi du lịch,
tree (n)	/triː/	cái cây
trouble (n)	/ˈtrʌb.əl/	vấn đề
true (adj)	/truː/	đúng
trust (n, v)	/trʌst/	sự tín nhiệm, lòng tin
twice (adv)	/twaɪs/	hai lần, gấp đôi
try (n, v)	/traɪ/	sự thử sức; thử, làm thử
uncle (n)	/ˈʌŋ.kəl/	chú, bác, cậu
under (prep)	/ˈʌn.dɚ/	ở dưới
understand (v)	/ˌʌn.dɚˈstænd/	hiểu, thông cảm
unit (n)	/ˈjuː.nɪt/	đơn vị, một khối
until (prep, conj)	/ʌnˈtɪl/	cho đến khi
usual (adj)	/ˈjuː.ʒu.əl/	như mọi khi
village (n)	/ˈvɪl.ɪdʒ/	làng, xã
voice (n)	/vɔɪs/	tiếng nói
visit (n)	/ˈvɪz.ɪt/	chuyến thăm
waste (n)	/weɪst/	rác
weather (n)	/ˈweð.ɚ/	thời tiết
wedding (n)	/ˈwed.ɪŋ/	đám cưới
week (n)	/wiːk/	tuần
weight (n)	/weɪt/	trọng lượng, cân nặng
welcome (v, adj)	/ˈwel.kəm/	chào đón, tiếp đón
wife (n)	/waɪf/	vợ, phu nhân
wild (adj)	/waɪld/	hoang dã, hoang dại
will (v)	/wɪl/	sẽ
win (n, v)	/wɪn/	sự chiến thắng
wind (n)	/wɪnd/	gió
wire (n)	/waɪr	dây nối
wise (adj)	/waɪz/	khôn ngoan, sáng suốt
yell (v)	/jel/	la hét
yesterday (n)	/ˈjes.tɚ.deɪ/	ngày hôm qua
yet (adv)	/jet/	còn, chưa kết thúc
young (adj)	/jʌŋ/	trẻ
zero (n)	/ˈzɪr.oʊ/	số 0
zoo (n)	/zuː/	sở thú
finger (n)	/ˈfɪŋ.ɡɚ/	ngón tay
knuckle (n)	/ˈnʌk.əl/	khớp ngón tay
neck (n)	/nek/	cổ
palm (n)	/pɑːm/	lòng bàn tay
shoulder (n)	/ˈʃoʊl.dɚ/	vai
throat (n)	/θroʊt/	cổ họng
thumb (n)	/θʌm/	ngón cái
waist (n)	/weɪst/	eo
wrist (n)	/rɪst/	cổ tay
foot (n)	/fʊt/	bàn chân
groin (n)	/ɡrɔɪn/	háng
heel (n)	/hiːl/	gót chân
hip (n)	/hɪp/	hông
knee (n)	/niː/	đầu gối
leg (n)	/leɡ/	bàn chân
apartment (n)	/əˈpɑːrt.mənt/	căn hộ
attic (n)	/ˈæt̬.ɪk/	gác mái
blanket (n)	/ˈblæŋ.kɪt/	tấm chăn
cabin (n)	/ˈkæb.ɪn/	buồng nhỏ
clock (n)	/klɑːk/	đồng hồ
dining room (n)	/ˈdaɪ.nɪŋ ˌruːm/	phòng ăn
draw (n)	/drɑː/	ngăn kéo
garden (n)	/ˈɡɑːr.dən/	khu vườn
gas fire (n)	/ˌɡæs ˈfaɪr/	bếp ga
iron (n)	/aɪrn/	bàn ủi
mirror (n)	/ˈmɪr.ɚ/	chiếc gương
mop (n)	/mɑːp/	cây lau nhà
oven (n)	/ˈʌv.ən/	lò nướng
pillow (n)	/ˈpɪl.oʊ/	gối
radiator (n)	/ˈreɪ.di.eɪ.t̬ɚ/	lò sưởi
refrigerator (n)	/rɪˈfrɪdʒ.ə.reɪ.t̬ɚ/	tủ lạnh
rug (n)	/rʌɡ/	thảm chùi chân
sponge (n)	/spʌndʒ/	đồ rửa chén
stool (n)	/stuːl/	ghế đẩu
switch (n)	/swɪtʃ/	công tắc
torch (n)	/tɔːrtʃ/	đèn pin
towel (n)	/taʊəl/	khăn tắm
villa (n)	/ˈvɪl.ə/	biệt thự
washing machine (n)	/ˈwɑː.ʃɪŋ məˌʃiːn/	máy giặt